Need fact-checking:

Anatolia
AL1 - Alevi.txt

Sunda
SMD - Sumedang.txt

South American Tribes
AHK - AHK.txt
CAR - Car.txt
CCH - CCH.txt
CHN - CHN.txt
CMA - CMA.txt
CNI - CNI.txt
CRG - CRG.txt
GCV - GCV.txt
GUC - GUC.txt
JIV - JIV.txt
KUZ - KUZ.txt
M4N - M4N.txt
OMC - OMC.txt
OMG - OMG.txt
TMI - TMI.txt

Japan
MYK - Miyakojima.txt

Taiwan
FRM - Formosa.txt

GB?
CRW - Crawford.txt

MGB - Maghreb.txt
RRR - Russia.txt
WKU - Wokou.txt
NSE - North Sea Empire.txt
SCF - Seven Council Fires.txt
NUA - Nahua Federation.txt