#Iberia
IBE = "countries/Iberia.txt"
MLA = "countries/Mallorca.txt"
VAL = "countries/Valencia.txt"
CNR = "countries/Canaries.txt"

#HRE
NGC = "countries/NorthGermanConfederation.txt"
SGC = "countries/SouthGermanConfederation.txt"
DNC = "countries/DanubeConfederacy.txt"
DIE = "countries/Worms.txt"
RBG = "countries/Regensburg.txt"
CMB = "countries/Cambrai.txt"
GRL = "countries/GreyLeagues.txt"
JUL = "countries/Julich.txt"
HOH = "countries/Hohenzollern.txt"
HEL = "countries/Heilbronn.txt"
DRM = "countries/Darmstadt.txt"
FLD = "countries/Fulda.txt"
BMB = "countries/Bamberg.txt"
BYR = "countries/Bayreuth.txt"
KMN = "countries/Kammin.txt"
RPN = "countries/Ruppin.txt"
STR = "countries/Stargard.txt"
OSN = "countries/Osnabruck.txt"
PDB = "countries/Paderborn.txt"
HOY = "countries/Hoya.txt"
SAA = "countries/Saarbrucken.txt"
ESN = "countries/Essen.txt"
DRT = "countries/Dortmund.txt"
MND = "countries/Minden.txt"
LIP = "countries/Lippe.txt"
KNS = "countries/Konstanz.txt"
MNT = "countries/Montfort.txt"
BSL = "countries/Basel.txt"
ZND = "countries/Zenden.txt"
MTZ = "countries/Metz.txt"
VDN = "countries/Verdun.txt"
GRN = "countries/Groningen.txt"
CNL = "countries/Carniola.txt"
FRE = "countries/Frisia.txt"
LTH = "countries/Lotharingia.txt"
FNC = "countries/Franconia.txt"
SWB = "countries/Swabia.txt"
CNT = "countries/Carinthia.txt"
BRN = "countries/Bern.txt"
GNV = "countries/Geneva.txt"
ZCH = "countries/Zurich.txt"
APZ = "countries/Appenzell.txt"

#Italy
BLG = "countries/Bologna.txt"
SZO = "countries/Saluzzo.txt"
TRN = "countries/Trent.txt"
ARE = "countries/Arezzo.txt"
MSS = "countries/Massa.txt"
PIO = "countries/Piombino.txt"
RMG = "countries/Romagna.txt"
GRZ = "countries/Gorizia.txt"
PGI = "countries/Perugia.txt"
CLB = "countries/Calabria.txt"

#Baltics
OSL = "countries/OselWiek.txt"
DRP = "countries/Dorpat.txt"


#Russia
SPK = "countries/Serpukhov.txt"
BLV = "countries/Belyov.txt"
MSL = "countries/Mosalsk.txt"
VTN = "countries/Vorotynsk.txt"
PRS = "countries/Pronsk.txt"
YLT = "countries/Yelets.txt"
MOZ = "countries/Mozhaysk.txt"
VYA = "countries/Vyatka.txt"
GLC = "countries/RussianGalich.txt"			
VLG = "countries/Vologda.txt"
ZBT = "countries/Zubtsov.txt"
MLG = "countries/Mologa.txt"

#Caucuses
KCH = "countries/Khachen.txt"
SHE = "countries/Sheki.txt"

#Britain
JER = "countries/JerseyandGuernsey.txt"
WMC = "countries/WelshMarches.txt"
AGV = "countries/Angevinia.txt"

#Ireland
ANR = "countries/Antrim.txt"
WEX = "countries/Wexford.txt"

#North Africa
ANF = "countries/Anfa.txt"
REG = "countries/Regraga.txt"
RIF = "countries/Riffans.txt"
NBA = "countries/Nubia.txt"
DBD = "countries/Debdou.txt"
LGH = "countries/Laghouat.txt"
OGL = "countries/Ouargla.txt"
BSM = "countries/BanuSulaym.txt"
HAW = "countries/Hawwara.txt"
GDM = "countries/Nafusi.txt"
ZAB = "countries/Zab.txt"

#Anatolia
CAP = "countries/Cappadocia.txt"
ALI = "countries/Alaiye.txt"
TKK = "countries/Tekke.txt"
LES = "countries/Lesbos.txt"

#Arabia
AZD = "countries/Azd.txt"
FDI = "countries/Fadhli.txt"
UNZ = "countries/Unaizah.txt"

#East Africa

SOC = "countries/Socotra.txt"

#North America
SLV = "countries/Slavey.txt"
DNE = "countries/Dene.txt"	
YYO = "countries/Tongva.txt"	
YZW = "countries/HawaiiNation.txt"
YKU = "countries/Yokuts.txt"
YZH = "countries/Missisauga.txt"
ALQ = "countries/Algonquin.txt"
CPY = "countries/Chipewyan.txt"
YPK = "countries/Yupik.txt"	
YYA = "countries/Denaina.txt"	
YZB = "countries/Lakota.txt"
WWJ = "countries/Opata.txt"
TGI	= "countries/Tlingit.txt"
CHS = "countries/Chumash.txt"	
MGT	= "countries/Innu.txt"	
ZIA = "countries/Zia.txt"	
HOP = "countries/Hopi.txt"		
ZNI = "countries/Zuni.txt"		
AOM = "countries/Acoma.txt"
